R 1920 1080
S ./text/barrel.xpm
SO ./text/brick.xpm     
 NO ./text/blue.xpm
WE ./text/door.xpm
EA ./text/grey.xpm

C 20,0,156
F  12,200,20   

111111111111111111111
1            12000021
1    11     1000000001
1          100000000001
11111111111000000000021
1000000000000E0000000001
111111111110000000000021
1          100000000001
1           1000000001
1            12000021
1             111111