R 1080 720

C 135, 245, 0
F 204,204, 0

S ./text/barrel.xpm
SO ./text/SO.xpm     
WE ./text/WE.xpm
EA ./text/blue.xpm
NO ./text/brick.xpm 




        11
      110011
    1100000011
  11002S20000011
  11002000000011
    1100000011
      110011
       1111