R 1080 720

C 135, 245, 0
F 204,204, 0

S ./text/barrel.xp
SO ./text/SO.xpm     
WE ./text/WE.xpm
EA ./text/blue.xpm
NO ./text/brick.xpm 




111111111111111
10000000000001
10000000000001
100000N0000001
10000000000001
11111111111111